1111111111111111
1000000000000001
1000000000000001
1000000000000001
1000000000000001
1000000000000001
1000000000000001
1000000000000001
1001000000000001
1000000100000001
1000000000001001
1111111111111111